▓▓▓▓▓▓▓▓▓▓▓▓▓▓▓▓▓▓▓▓▓▓▓▓▓▓▓▓▓▓▓▓▓▓▓▓▓▓▓▓______▓▓▓▓▓▓▓▓▓▓▓▓▓▓▓▓▓▓▓▓▓▓▓▓▓▓▓▓▓▓▓▓▓▓▓▓▓▓▓▓▓▓▓▓
▓........................................................................................▓
▓........................................................................................▓
▓........................................................................................▓
▓........................................................................................▓
▓........................................................................................▓
▓........................................................................................▓
▓........................................................................................▓
▓........................................................................................▓
▓........................................................................................▓
▓........................................................................................▓
▓........................................................................................▓
▓........................................................................................▓
▓........................................................................................▓
▓........................................................................................▓
▓........................................................................................▓
▓........................................................................................▓
|........................................................................................|
|........................................................................................|
|........................................................................................|
▓........................................................................................▓
▓........................................................................................▓
▓........................................................................................▓
▓........................................................................................▓
▓........................................................................................▓
▓▒▒▒▒▒▒▒▒▒▒▒▒▒▒▒▒▒▒▒▒▒▒▒▒▒▒▒▒▒..............................▒▒▒▒▒▒▒▒▒▒▒▒▒▒▒▒▒▒▒▒▒▒▒▒▒▒▒▒▒▓
▓............................▒..............................▒............................▓
▓............................▒..............................▒............................▓
▓............................▒..............................▒............................▓
▓............................▒..............................▒............................▓
▓............................]..............................]............................▓
▓............................]..............................]............................▓
▓............................]..............................]............................▓
▓............................▒..............................▒............................▓
▓............................▒..............................▒............................▓
▓............................▒..............................▒............................▓
▓............................▒..............................▒............................▓
▓............................▒..............................▒............................▓
▓............................▒..............................▒............................▓
▓............................▒..............................▒............................▓
▓............................▒..............................▒............................▓
▓............................▒..............................▒............................▓
▓............................▒..............................▒............................▓
▓............................▒..............................▒............................▓
▓............................▒..............................▒............................▓
▓............................▒..............................▒............................▓
▓............................▒..............................▒............................▓
▓----▒▒▒▒▒▒▒▒▒▒▒▒▒▒▒▒▒▒▒▒▒▒▒▒▒..............................▒▒▒▒▒▒▒▒▒▒▒▒▒▒▒▒▒▒▒▒▒▒▒▒-----▓
▓........................................................................................▓
▓........................................................................................▓
▓▓▓▓▓▓▓▓▓▓▓▓▓▓▓▓▓▓▓▓▓▓▓▓▓▓▓▓▓▓▓▓▓▓▓▓▓▓▓▓______▓▓▓▓▓▓▓▓▓▓▓▓▓▓▓▓▓▓▓▓▓▓▓▓▓▓▓▓▓▓▓▓▓▓▓▓▓▓▓▓▓▓▓▓


